9
9
555555555
555555555
555555555
555011055
550205305
555005555
555040555
555505555
555555555