9
9
555555555
555555555
555555555
555011055
550205305
555005055
555040555
555505555
555555555
9
9
011111113
311111113
311111113
311111113
311111113
311111113
311111113
311111113
311111110
9
9
011121110
313343313
053313350
311010113
311141113
312010213
151515151
150515051
311121113